1111111
1CCCCC1
1PCCCC1
1CCCCE1
1111111