11111
1CCC11
1CCC1
1P0E1
11111