111111
1001C1
1001E1
1P0101
111111