11111111111111
10010000000C01
10000111110011
1P0011E0000011
11111111111111