111111111111111111111111111111111111111111111111111111111111111111111111111111111
1E0000000000000C00000C0000V000011111111111111111111111111111111111111111111111001
101001010010000010100100000001000000000000000000000000000000000000000000000000001
10100100101010100010010000V001011111111111111111111111111111111111111111111111101
1P0000000CV0C0000000000000V0000111111111111111111111111111111111111111111111110C1
111111111111111111111111111111111111111111111111111111111111111111111111111111111