1111111111111111111111111111111111
1E0000000000000C00000C0000V0000001
1010010100100000101001000000010101
10100100101010100010010000V0010101
1P0000000CV0C0000000000000V00000C1
1111111111111111111111111111111111