1111111111111111111111111111111111
1C000000000000000000000000000000C1
1000000000000000000000000000000001
1000000000000000000000000000000001
1000000000000000V00000000000000001
10000000000000V000V000000000000001
100000000000V000P000V0000000000001
10000000000000V0E0V000000000000001
1000000000000000V00000000000000001
1000000000000000000000000000000001
1000000000000000000000000000000001
1000000000000000000000000000000001
1C000000000000000000000000000000C1
1111111111111111111111111111111111